SO ./textures/wall_1.xpm
NO ./textures/wall_2.xpm
WE ./textures/grass.xpm
EA ./textures/bedrock.xpm
C 6,84,136
F 108,255,93





        1111111111111111111111111
        1000000000110000000000001
        1011000001110000000000001
        1001000000000000000000001
111111111011000001000000000000001
10000000001100001000111110111111
111101111111110111N0000010001
11110111111111011101010010001
11000000110101011100000010001
10000000000000001100000000001
10000000000000001101010000101
11000001110101011111011101001
11110111 1110101 101111010001
11111111 1111111 111111111111


